Date,Platform,Follower Count,Likes,Shares,Comments,Total Engagement,Sentiment Score
2024-01-01,Twitter,12026,206,71,42,319,Neutral
2024-01-02,Instagram,13989,139,68,65,272,Negative
2024-01-03,Instagram,16447,216,39,54,309,Negative
2024-01-04,Instagram,19412,446,29,52,527,Negative
2024-01-05,Twitter,15257,264,68,22,354,Positive
2024-01-06,Instagram,15706,321,45,41,407,Negative
2024-01-07,Twitter,14863,445,44,39,528,Positive
2024-01-08,Instagram,15235,278,97,30,405,Positive
2024-01-09,Instagram,16945,385,71,56,512,Neutral
2024-01-10,Twitter,19967,343,42,19,404,Positive
2024-01-11,Facebook,13231,402,34,56,492,Negative
2024-01-12,Facebook,15296,387,29,12,428,Neutral
2024-01-13,Instagram,18787,278,94,67,439,Negative
2024-01-14,Twitter,16261,267,43,30,340,Negative
2024-01-15,Instagram,19794,382,24,30,436,Neutral
2024-01-16,Instagram,17821,177,89,69,335,Positive
2024-01-17,Twitter,17589,161,87,43,291,Negative
2024-01-18,Facebook,16635,122,48,15,185,Positive
2024-01-19,Instagram,10715,320,96,58,474,Neutral
2024-01-20,Instagram,14966,194,31,23,248,Positive
2024-01-21,Instagram,10929,387,72,45,504,Neutral
2024-01-22,Instagram,19227,186,23,19,228,Positive
2024-01-23,Instagram,10217,292,92,34,418,Positive
2024-01-24,Instagram,15196,333,39,37,409,Neutral
2024-01-25,Facebook,12753,304,80,42,426,Positive
2024-01-26,Facebook,13501,305,69,55,429,Neutral
2024-01-27,Facebook,13845,290,54,46,390,Neutral
2024-01-28,Twitter,19859,231,63,62,356,Negative
2024-01-29,Instagram,15963,132,25,56,213,Neutral
2024-01-30,Facebook,18028,162,99,54,315,Positive
2024-01-31,Twitter,10210,181,64,65,310,Positive
2024-02-01,Twitter,19682,213,42,59,314,Negative
2024-02-02,Twitter,17718,248,62,39,349,Positive
2024-02-03,Twitter,15926,319,22,19,360,Positive
2024-02-04,Facebook,16051,162,89,43,294,Negative
2024-02-05,Facebook,13655,159,76,47,282,Neutral
2024-02-06,Twitter,11377,289,48,23,360,Negative
2024-02-07,Twitter,18842,301,29,15,345,Neutral
2024-02-08,Instagram,12506,140,46,17,203,Neutral
2024-02-09,Facebook,13861,284,29,57,370,Positive
2024-02-10,Instagram,15169,466,90,44,600,Neutral
2024-02-11,Twitter,19733,293,47,63,403,Neutral
2024-02-12,Twitter,16603,118,82,57,257,Positive
2024-02-13,Facebook,13214,308,24,68,400,Negative
2024-02-14,Facebook,19764,473,62,63,598,Positive
2024-02-15,Twitter,17493,132,71,37,240,Negative
2024-02-16,Facebook,15838,175,46,37,258,Negative
2024-02-17,Facebook,16969,278,40,49,367,Positive
2024-02-18,Facebook,10624,490,95,56,641,Positive
2024-02-19,Twitter,13529,235,98,51,384,Positive
2024-02-20,Instagram,16344,467,67,32,566,Negative
2024-02-21,Twitter,19556,223,76,36,335,Positive
2024-02-22,Instagram,19775,157,29,48,234,Negative
2024-02-23,Facebook,12725,283,65,15,363,Positive
2024-02-24,Facebook,10439,396,47,26,469,Neutral
2024-02-25,Twitter,10273,190,40,25,255,Neutral
2024-02-26,Instagram,16369,252,45,55,352,Negative
2024-02-27,Twitter,15304,286,55,27,368,Positive
2024-02-28,Instagram,15395,371,31,50,452,Neutral
2024-02-29,Instagram,15187,263,44,58,365,Positive
2024-03-01,Twitter,18952,465,43,54,562,Negative
2024-03-02,Instagram,18238,366,61,43,470,Negative
2024-03-03,Twitter,11020,315,96,25,436,Neutral
2024-03-04,Facebook,17974,232,85,56,373,Neutral
2024-03-05,Twitter,10813,334,27,63,424,Negative
2024-03-06,Instagram,17515,300,84,56,440,Negative
2024-03-07,Facebook,15526,229,62,45,336,Positive
2024-03-08,Instagram,19157,175,45,67,287,Negative
2024-03-09,Twitter,15278,244,69,33,346,Negative
2024-03-10,Facebook,14710,163,30,65,258,Negative
2024-03-11,Facebook,18683,206,86,31,323,Neutral
2024-03-12,Instagram,11277,278,49,48,375,Positive
2024-03-13,Facebook,14299,482,40,55,577,Neutral
2024-03-14,Instagram,11364,399,41,38,478,Negative
2024-03-15,Facebook,19183,407,51,32,490,Neutral
2024-03-16,Twitter,13655,158,76,49,283,Positive
2024-03-17,Twitter,17943,126,77,20,223,Positive
2024-03-18,Twitter,13348,220,67,43,330,Negative
2024-03-19,Instagram,13832,341,77,23,441,Positive
2024-03-20,Facebook,18744,495,85,45,625,Neutral
2024-03-21,Instagram,14296,145,76,22,243,Positive
2024-03-22,Instagram,14011,215,74,15,304,Negative
2024-03-23,Twitter,15823,337,56,22,415,Neutral
2024-03-24,Facebook,17227,189,35,15,239,Neutral
2024-03-25,Instagram,14637,113,29,15,157,Neutral
2024-03-26,Instagram,12277,166,51,56,273,Negative
2024-03-27,Instagram,13903,428,50,45,523,Negative
2024-03-28,Twitter,12462,341,52,65,458,Neutral
2024-03-29,Facebook,12781,447,94,40,581,Neutral
2024-03-30,Instagram,13458,400,20,64,484,Negative
2024-03-31,Facebook,15572,228,32,51,311,Neutral
2024-04-01,Twitter,13238,255,48,37,340,Positive
2024-04-02,Instagram,17936,487,67,32,586,Negative
2024-04-03,Facebook,17323,260,83,39,382,Neutral
2024-04-04,Facebook,16883,366,27,58,451,Negative
2024-04-05,Twitter,12205,161,71,27,259,Neutral
2024-04-06,Instagram,19739,375,47,38,460,Negative
2024-04-07,Twitter,18719,284,97,49,430,Positive
2024-04-08,Instagram,10247,131,98,47,276,Negative
2024-04-09,Twitter,19939,213,80,21,314,Neutral
2024-04-10,Instagram,19283,231,91,13,335,Negative
2024-04-11,Instagram,16506,391,22,27,440,Positive
2024-04-12,Instagram,13114,103,94,12,209,Negative
2024-04-13,Instagram,10261,422,69,55,546,Neutral
2024-04-14,Twitter,18230,164,24,10,198,Positive
2024-04-15,Instagram,13970,137,57,60,254,Negative
2024-04-16,Twitter,12704,403,32,22,457,Neutral
2024-04-17,Facebook,19111,120,21,37,178,Negative
2024-04-18,Twitter,12904,240,69,20,329,Positive
2024-04-19,Twitter,14474,145,86,43,274,Positive
2024-04-20,Instagram,11124,142,44,19,205,Positive
2024-04-21,Instagram,11680,264,37,39,340,Neutral
2024-04-22,Twitter,12819,231,90,31,352,Neutral
2024-04-23,Twitter,10364,297,49,52,398,Positive
2024-04-24,Instagram,16356,124,39,15,178,Neutral
2024-04-25,Twitter,11994,400,61,40,501,Neutral
2024-04-26,Twitter,11473,189,80,59,328,Neutral
2024-04-27,Instagram,13236,142,55,65,262,Neutral
2024-04-28,Facebook,10065,283,43,32,358,Positive
2024-04-29,Twitter,13647,229,62,14,305,Neutral
2024-04-30,Twitter,10347,346,42,24,412,Negative
2024-05-01,Twitter,11510,218,31,26,275,Neutral
2024-05-02,Instagram,15634,270,55,39,364,Negative
2024-05-03,Twitter,18002,439,35,14,488,Positive
2024-05-04,Twitter,16696,247,74,33,354,Negative
2024-05-05,Twitter,16063,311,41,50,402,Neutral
2024-05-06,Instagram,16794,367,53,51,471,Positive
2024-05-07,Instagram,12538,387,76,22,485,Negative
2024-05-08,Facebook,15024,443,46,63,552,Neutral
2024-05-09,Instagram,18417,311,92,51,454,Neutral
2024-05-10,Instagram,16255,319,71,62,452,Negative
2024-05-11,Twitter,14487,474,45,32,551,Neutral
2024-05-12,Facebook,17068,230,65,45,340,Positive
2024-05-13,Instagram,13895,169,32,49,250,Positive
2024-05-14,Instagram,10047,273,39,67,379,Negative
2024-05-15,Instagram,16560,280,37,42,359,Neutral
2024-05-16,Instagram,19058,112,56,48,216,Positive
2024-05-17,Instagram,18760,216,67,58,341,Positive
2024-05-18,Twitter,19471,387,27,25,439,Positive
2024-05-19,Instagram,13575,221,90,39,350,Positive
2024-05-20,Instagram,16249,343,54,48,445,Neutral
2024-05-21,Twitter,19664,142,74,56,272,Positive
2024-05-22,Twitter,19625,243,54,50,347,Neutral
2024-05-23,Instagram,17533,455,30,46,531,Positive
2024-05-24,Instagram,13999,326,58,31,415,Positive
2024-05-25,Facebook,19224,284,66,19,369,Neutral
2024-05-26,Facebook,13094,260,71,68,399,Negative
2024-05-27,Twitter,14914,233,59,39,331,Neutral
2024-05-28,Facebook,17069,436,60,48,544,Neutral
2024-05-29,Twitter,15275,230,32,41,303,Negative
2024-05-30,Twitter,18133,244,30,11,285,Positive
2024-05-31,Instagram,11011,276,39,53,368,Negative
2024-06-01,Facebook,12254,415,50,54,519,Negative
2024-06-02,Twitter,10585,458,28,24,510,Negative
2024-06-03,Instagram,15694,337,71,42,450,Neutral
2024-06-04,Facebook,19236,108,68,62,238,Negative
2024-06-05,Instagram,15522,168,77,61,306,Positive
2024-06-06,Instagram,19870,161,66,30,257,Neutral
2024-06-07,Twitter,17136,257,40,59,356,Negative
2024-06-08,Instagram,14794,123,36,30,189,Negative
2024-06-09,Twitter,13757,400,31,50,481,Neutral
2024-06-10,Twitter,13941,255,92,62,409,Negative
2024-06-11,Instagram,10234,401,63,64,528,Negative
2024-06-12,Facebook,18525,347,45,65,457,Neutral
2024-06-13,Facebook,12244,317,35,57,409,Positive
2024-06-14,Twitter,13125,194,58,11,263,Positive
2024-06-15,Twitter,19430,429,80,68,577,Positive
2024-06-16,Twitter,15870,268,86,29,383,Neutral
2024-06-17,Instagram,10382,379,69,69,517,Neutral
2024-06-18,Twitter,11930,107,72,17,196,Neutral
2024-06-19,Facebook,19387,280,53,19,352,Neutral
2024-06-20,Facebook,19412,203,47,63,313,Negative
2024-06-21,Facebook,11152,241,61,41,343,Neutral
2024-06-22,Instagram,13461,337,93,56,486,Neutral
2024-06-23,Twitter,11567,415,45,44,504,Neutral
2024-06-24,Twitter,18922,342,26,43,411,Positive
2024-06-25,Twitter,16727,112,74,60,246,Neutral
2024-06-26,Facebook,16782,381,60,60,501,Negative
2024-06-27,Twitter,14564,230,82,37,349,Neutral
2024-06-28,Twitter,17335,231,29,68,328,Neutral
2024-06-29,Facebook,12406,407,65,21,493,Positive
2024-06-30,Instagram,12168,472,49,38,559,Positive
2024-07-01,Twitter,14887,329,63,29,421,Negative
2024-07-02,Facebook,13000,236,75,61,372,Neutral
2024-07-03,Instagram,16921,215,48,67,330,Negative
2024-07-04,Twitter,15397,344,75,20,439,Negative
2024-07-05,Instagram,19970,315,56,44,415,Neutral
2024-07-06,Instagram,15810,252,94,62,408,Neutral
2024-07-07,Instagram,18832,492,23,63,578,Neutral
2024-07-08,Twitter,10604,413,83,13,509,Positive
2024-07-09,Twitter,19019,312,72,48,432,Positive
2024-07-10,Instagram,16729,109,65,60,234,Positive
2024-07-11,Twitter,18557,403,37,57,497,Positive
2024-07-12,Facebook,12083,358,33,66,457,Negative
2024-07-13,Twitter,16447,256,98,14,368,Positive
2024-07-14,Instagram,15301,284,97,16,397,Negative
2024-07-15,Twitter,19230,219,32,54,305,Neutral
2024-07-16,Instagram,12045,171,87,61,319,Positive
2024-07-17,Facebook,17823,228,29,36,293,Negative
2024-07-18,Facebook,14955,205,29,47,281,Negative
2024-07-19,Facebook,14365,337,55,39,431,Negative
2024-07-20,Facebook,13113,429,97,42,568,Negative
2024-07-21,Facebook,16735,230,87,41,358,Positive
2024-07-22,Instagram,16406,337,49,14,400,Negative
2024-07-23,Twitter,16302,175,79,36,290,Negative
2024-07-24,Instagram,17195,342,55,12,409,Positive
2024-07-25,Facebook,12023,108,61,43,212,Negative
2024-07-26,Instagram,12056,226,91,51,368,Neutral
2024-07-27,Facebook,16288,398,90,30,518,Negative
2024-07-28,Facebook,19103,317,36,53,406,Negative
2024-07-29,Instagram,13512,319,66,43,428,Negative
2024-07-30,Twitter,12717,265,81,42,388,Negative
2024-07-31,Facebook,19902,281,30,16,327,Positive
2024-08-01,Instagram,10189,388,74,28,490,Neutral
2024-08-02,Twitter,12867,317,67,42,426,Positive
2024-08-03,Facebook,18831,137,49,58,244,Neutral
2024-08-04,Twitter,11428,130,78,47,255,Neutral
2024-08-05,Twitter,15016,301,70,66,437,Neutral
2024-08-06,Instagram,15104,409,38,13,460,Positive
2024-08-07,Instagram,11581,470,93,13,576,Positive
2024-08-08,Instagram,10998,251,81,43,375,Positive
2024-08-09,Twitter,15122,142,87,22,251,Positive
2024-08-10,Instagram,19599,369,45,31,445,Positive
2024-08-11,Instagram,16097,219,54,59,332,Negative
2024-08-12,Instagram,17189,336,69,22,427,Negative
2024-08-13,Facebook,14775,463,65,45,573,Negative
2024-08-14,Instagram,18461,420,26,34,480,Negative
2024-08-15,Twitter,17068,439,43,69,551,Negative
2024-08-16,Twitter,19677,115,79,32,226,Positive
2024-08-17,Facebook,11643,474,55,46,575,Neutral
2024-08-18,Instagram,11056,469,88,34,591,Positive
2024-08-19,Twitter,10517,423,36,37,496,Positive
2024-08-20,Instagram,12114,352,86,56,494,Negative
2024-08-21,Instagram,15275,180,73,32,285,Positive
2024-08-22,Twitter,18022,303,66,43,412,Negative
2024-08-23,Twitter,13861,155,83,47,285,Neutral
2024-08-24,Instagram,15203,150,68,30,248,Neutral
2024-08-25,Facebook,12806,347,29,21,397,Negative
2024-08-26,Instagram,16838,293,73,22,388,Positive
2024-08-27,Facebook,11757,308,72,69,449,Positive
2024-08-28,Instagram,12533,368,80,68,516,Positive
2024-08-29,Instagram,17357,293,79,16,388,Neutral
2024-08-30,Instagram,18870,267,78,17,362,Positive
2024-08-31,Twitter,14613,157,95,45,297,Neutral
2024-09-01,Instagram,15002,495,43,22,560,Neutral
2024-09-02,Facebook,15955,188,32,23,243,Neutral
2024-09-03,Twitter,18072,325,99,17,441,Negative
2024-09-04,Instagram,12990,216,52,43,311,Negative
2024-09-05,Facebook,15541,376,47,54,477,Negative
2024-09-06,Instagram,11584,470,36,40,546,Positive
2024-09-07,Facebook,11673,244,72,68,384,Negative
2024-09-08,Facebook,18400,232,70,20,322,Positive
2024-09-09,Facebook,16686,186,54,17,257,Positive
2024-09-10,Instagram,16029,119,91,61,271,Positive
2024-09-11,Facebook,14923,258,78,40,376,Negative
2024-09-12,Facebook,12467,113,77,57,247,Neutral
2024-09-13,Facebook,14823,214,30,30,274,Neutral
2024-09-14,Instagram,16844,428,89,14,531,Negative
2024-09-15,Twitter,17654,457,51,20,528,Neutral
2024-09-16,Twitter,12314,323,83,29,435,Positive
2024-09-17,Instagram,13913,455,52,64,571,Neutral
2024-09-18,Twitter,14903,206,20,38,264,Neutral
2024-09-19,Twitter,18633,357,76,13,446,Neutral
2024-09-20,Facebook,17433,435,25,47,507,Negative
2024-09-21,Instagram,11171,408,65,40,513,Neutral
2024-09-22,Instagram,19327,101,69,55,225,Positive
2024-09-23,Instagram,15701,479,83,68,630,Negative
2024-09-24,Instagram,17307,287,94,14,395,Positive
2024-09-25,Twitter,13407,253,27,22,302,Neutral
2024-09-26,Twitter,11358,351,83,35,469,Neutral
2024-09-27,Instagram,15428,327,36,37,400,Neutral
2024-09-28,Facebook,13503,380,97,46,523,Negative
2024-09-29,Twitter,19712,187,30,12,229,Neutral
2024-09-30,Facebook,17283,195,94,55,344,Positive
2024-10-01,Facebook,13722,204,23,52,279,Neutral
2024-10-02,Instagram,14607,397,36,32,465,Positive
2024-10-03,Facebook,19673,150,22,63,235,Positive
2024-10-04,Twitter,18535,321,56,15,392,Negative
2024-10-05,Twitter,14255,155,94,20,269,Neutral
2024-10-06,Twitter,12753,281,42,36,359,Positive
2024-10-07,Facebook,12112,182,92,34,308,Negative
2024-10-08,Twitter,14738,244,40,68,352,Neutral
2024-10-09,Facebook,10770,197,54,43,294,Negative
2024-10-10,Facebook,16131,467,50,56,573,Negative
2024-10-11,Instagram,14155,385,60,47,492,Neutral
2024-10-12,Facebook,15122,215,79,27,321,Negative
2024-10-13,Twitter,11083,364,55,31,450,Positive
2024-10-14,Instagram,19696,186,73,55,314,Positive
2024-10-15,Facebook,12297,185,35,34,254,Positive
2024-10-16,Twitter,18830,404,29,62,495,Neutral
2024-10-17,Facebook,13358,417,33,36,486,Negative
2024-10-18,Twitter,12945,155,41,38,234,Neutral
2024-10-19,Instagram,10332,101,21,38,160,Neutral
2024-10-20,Twitter,13220,499,82,14,595,Neutral
2024-10-21,Facebook,13679,143,25,55,223,Negative
2024-10-22,Twitter,15349,441,21,22,484,Neutral
2024-10-23,Facebook,18764,339,81,51,471,Positive
2024-10-24,Facebook,12280,403,90,46,539,Neutral
2024-10-25,Facebook,17523,252,66,29,347,Negative
2024-10-26,Instagram,10632,132,86,43,261,Neutral
2024-10-27,Facebook,12101,474,77,34,585,Neutral
2024-10-28,Twitter,12131,290,69,19,378,Negative
2024-10-29,Twitter,10156,449,71,28,548,Negative
2024-10-30,Instagram,12971,202,35,65,302,Neutral
2024-10-31,Instagram,15570,164,64,68,296,Neutral
2024-11-01,Facebook,19833,496,83,28,607,Negative
2024-11-02,Facebook,13590,358,22,66,446,Positive
2024-11-03,Facebook,16261,109,85,40,234,Negative
2024-11-04,Instagram,14538,335,81,20,436,Neutral
2024-11-05,Instagram,12234,334,65,52,451,Negative
2024-11-06,Twitter,19132,303,67,61,431,Negative
2024-11-07,Instagram,10428,396,33,37,466,Positive
2024-11-08,Facebook,10034,497,94,65,656,Neutral
2024-11-09,Twitter,19922,271,69,66,406,Neutral
2024-11-10,Twitter,14590,305,64,29,398,Positive
2024-11-11,Facebook,19219,470,37,63,570,Neutral
2024-11-12,Twitter,12747,378,80,65,523,Negative
2024-11-13,Instagram,19680,399,64,54,517,Neutral
2024-11-14,Instagram,13583,162,39,54,255,Positive
2024-11-15,Twitter,17910,354,76,63,493,Positive
2024-11-16,Facebook,10604,437,98,16,551,Negative
2024-11-17,Twitter,15752,282,58,27,367,Positive
2024-11-18,Instagram,12940,420,67,39,526,Negative
2024-11-19,Facebook,10983,463,44,33,540,Negative
2024-11-20,Twitter,16255,386,56,49,491,Neutral
2024-11-21,Facebook,14675,216,47,25,288,Neutral
2024-11-22,Twitter,11652,108,27,65,200,Negative
2024-11-23,Instagram,15500,153,35,14,202,Negative
2024-11-24,Twitter,16572,389,30,35,454,Negative
2024-11-25,Instagram,18644,102,94,49,245,Positive
2024-11-26,Facebook,11682,216,64,68,348,Negative
2024-11-27,Twitter,12620,434,26,62,522,Neutral
2024-11-28,Twitter,17117,238,31,38,307,Positive
2024-11-29,Facebook,13886,437,70,54,561,Negative
2024-11-30,Twitter,17747,345,79,67,491,Positive
2024-12-01,Twitter,10608,301,60,28,389,Positive
2024-12-02,Facebook,17770,302,86,38,426,Neutral
2024-12-03,Instagram,10503,124,45,18,187,Positive
2024-12-04,Twitter,10485,365,82,47,494,Negative
2024-12-05,Instagram,13276,147,80,60,287,Negative
2024-12-06,Twitter,13816,188,85,55,328,Neutral
2024-12-07,Twitter,18838,192,48,34,274,Negative
2024-12-08,Facebook,19178,153,34,40,227,Negative
2024-12-09,Twitter,17805,257,75,10,342,Negative
2024-12-10,Instagram,13197,275,54,41,370,Neutral
2024-12-11,Instagram,19053,464,58,26,548,Positive
2024-12-12,Twitter,15105,135,55,11,201,Neutral
2024-12-13,Facebook,16347,214,64,34,312,Positive
2024-12-14,Twitter,16028,494,90,20,604,Negative
2024-12-15,Facebook,12634,389,45,67,501,Neutral
2024-12-16,Twitter,19146,128,34,69,231,Neutral
2024-12-17,Twitter,12803,358,59,60,477,Positive
2024-12-18,Twitter,19547,276,41,18,335,Negative
2024-12-19,Facebook,18643,470,90,19,579,Negative
2024-12-20,Facebook,13484,373,66,39,478,Neutral
2024-12-21,Twitter,17111,378,91,32,501,Negative
2024-12-22,Twitter,18014,125,84,57,266,Positive
2024-12-23,Twitter,17692,189,53,45,287,Positive
2024-12-24,Facebook,19006,207,87,34,328,Neutral
2024-12-25,Twitter,14050,439,35,23,497,Negative
2024-12-26,Twitter,11176,400,52,45,497,Neutral
2024-12-27,Facebook,11264,301,34,18,353,Neutral
2024-12-28,Facebook,10252,223,48,67,338,Negative
2024-12-29,Instagram,10197,409,49,24,482,Negative
2024-12-30,Facebook,16321,428,34,31,493,Negative
2024-12-31,Facebook,16448,446,33,10,489,Negative
2025-01-01,Instagram,10819,340,97,48,485,Negative
2025-01-02,Instagram,11623,499,81,62,642,Negative
2025-01-03,Twitter,19791,375,36,45,456,Negative
2025-01-04,Facebook,11028,422,51,23,496,Positive
2025-01-05,Facebook,19375,126,27,34,187,Negative
2025-01-06,Instagram,11914,178,92,64,334,Negative
2025-01-07,Instagram,12620,103,69,13,185,Neutral
2025-01-08,Instagram,12665,278,53,21,352,Negative
2025-01-09,Facebook,16140,202,21,21,244,Negative
2025-01-10,Instagram,10716,180,49,33,262,Negative
2025-01-11,Twitter,14152,351,89,31,471,Negative
2025-01-12,Instagram,11881,281,95,37,413,Neutral
2025-01-13,Instagram,15557,291,49,63,403,Positive
2025-01-14,Facebook,14658,356,31,55,442,Neutral
2025-01-15,Twitter,17255,321,81,31,433,Neutral
2025-01-16,Instagram,15376,451,60,10,521,Positive
2025-01-17,Instagram,19881,374,53,55,482,Negative
2025-01-18,Instagram,10499,456,83,54,593,Positive
2025-01-19,Facebook,12593,250,68,17,335,Positive
2025-01-20,Instagram,16656,344,74,23,441,Neutral
2025-01-21,Instagram,19785,405,34,38,477,Neutral
2025-01-22,Facebook,16614,301,66,55,422,Positive
2025-01-23,Facebook,12824,408,90,29,527,Negative
2025-01-24,Instagram,16708,286,36,18,340,Positive
2025-01-25,Instagram,12442,485,46,61,592,Neutral
2025-01-26,Instagram,11270,153,69,15,237,Positive
2025-01-27,Instagram,19427,353,23,46,422,Positive
2025-01-28,Instagram,12053,364,26,48,438,Negative
2025-01-29,Instagram,19164,400,54,22,476,Neutral
2025-01-30,Instagram,13449,417,73,22,512,Neutral
2025-01-31,Instagram,16258,108,58,27,193,Neutral
2025-02-01,Twitter,12039,256,38,59,353,Negative
2025-02-02,Twitter,12897,421,96,39,556,Negative
2025-02-03,Twitter,16397,290,87,47,424,Positive
2025-02-04,Twitter,19967,207,37,38,282,Negative
2025-02-05,Twitter,16003,185,81,51,317,Positive
2025-02-06,Facebook,10016,208,82,36,326,Positive
2025-02-07,Instagram,15614,270,48,68,386,Negative
2025-02-08,Twitter,16314,466,22,30,518,Negative
2025-02-09,Twitter,18610,270,48,33,351,Negative
2025-02-10,Facebook,13889,433,80,55,568,Neutral
2025-02-11,Instagram,18514,340,53,43,436,Neutral
2025-02-12,Facebook,17671,105,81,34,220,Neutral
2025-02-13,Twitter,11386,375,72,65,512,Negative
2025-02-14,Twitter,19150,348,40,62,450,Negative
2025-02-15,Instagram,19533,495,25,48,568,Negative
2025-02-16,Twitter,13782,246,69,18,333,Positive
2025-02-17,Facebook,14685,313,84,57,454,Positive
2025-02-18,Instagram,13478,456,69,67,592,Negative
2025-02-19,Facebook,10625,289,33,52,374,Neutral
2025-02-20,Twitter,18390,297,40,56,393,Negative
2025-02-21,Facebook,10439,271,64,37,372,Neutral
2025-02-22,Facebook,15750,206,63,35,304,Neutral
2025-02-23,Facebook,10987,256,94,61,411,Positive
2025-02-24,Facebook,18328,228,99,35,362,Negative
2025-02-25,Twitter,17685,470,82,40,592,Neutral
2025-02-26,Facebook,12443,335,66,26,427,Negative
2025-02-27,Instagram,19939,319,43,53,415,Neutral
2025-02-28,Instagram,14630,367,65,40,472,Negative
2025-03-01,Facebook,14599,120,98,61,279,Negative
2025-03-02,Twitter,14723,159,88,37,284,Neutral
2025-03-03,Facebook,11072,359,73,28,460,Negative
2025-03-04,Facebook,12265,463,67,51,581,Neutral
2025-03-05,Twitter,13093,401,47,33,481,Neutral
2025-03-06,Instagram,19348,438,33,47,518,Negative
2025-03-07,Twitter,15886,453,93,45,591,Negative
2025-03-08,Instagram,15204,409,48,22,479,Negative
2025-03-09,Facebook,12545,376,82,29,487,Positive
2025-03-10,Twitter,13669,468,23,60,551,Neutral
2025-03-11,Facebook,18963,398,81,56,535,Neutral
2025-03-12,Twitter,10007,110,49,65,224,Positive
2025-03-13,Twitter,13424,362,79,19,460,Neutral
2025-03-14,Twitter,19431,311,52,23,386,Positive
2025-03-15,Twitter,12623,456,61,19,536,Positive
2025-03-16,Twitter,14694,263,42,54,359,Negative
2025-03-17,Instagram,11785,378,24,67,469,Neutral
2025-03-18,Instagram,18290,352,93,58,503,Negative
2025-03-19,Twitter,10540,387,72,59,518,Neutral
2025-03-20,Facebook,13035,331,24,16,371,Positive
2025-03-21,Twitter,15270,195,20,27,242,Positive
2025-03-22,Instagram,11486,436,81,17,534,Negative
2025-03-23,Instagram,16114,449,78,58,585,Neutral
2025-03-24,Twitter,12834,377,29,26,432,Negative
2025-03-25,Twitter,19310,154,67,25,246,Negative
2025-03-26,Twitter,16204,305,54,67,426,Neutral
2025-03-27,Instagram,11000,240,99,67,406,Neutral
2025-03-28,Facebook,16005,105,82,57,244,Negative
2025-03-29,Instagram,10082,425,46,67,538,Positive
2025-03-30,Twitter,13741,384,93,52,529,Neutral
2025-03-31,Instagram,17721,263,98,33,394,Negative
2025-04-01,Twitter,15968,292,56,62,410,Negative
2025-04-02,Twitter,16146,191,85,21,297,Negative
2025-04-03,Twitter,18327,378,78,66,522,Positive
2025-04-04,Twitter,17828,234,91,38,363,Neutral
2025-04-05,Twitter,18949,138,47,20,205,Negative
2025-04-06,Facebook,18419,151,60,55,266,Positive
2025-04-07,Facebook,16959,175,64,61,300,Negative
2025-04-08,Facebook,18081,202,94,37,333,Positive
2025-04-09,Instagram,11763,477,92,40,609,Neutral
2025-04-10,Facebook,16531,452,66,34,552,Negative
2025-04-11,Instagram,16177,398,27,15,440,Negative
2025-04-12,Twitter,14884,326,33,60,419,Neutral
2025-04-13,Facebook,16887,291,77,14,382,Positive
2025-04-14,Instagram,16245,478,79,11,568,Negative
2025-04-15,Twitter,15800,159,63,59,281,Neutral
2025-04-16,Twitter,11056,407,35,13,455,Negative
2025-04-17,Instagram,10327,308,41,46,395,Neutral
2025-04-18,Instagram,17987,362,93,40,495,Positive
2025-04-19,Instagram,19907,288,30,40,358,Positive
2025-04-20,Instagram,14340,326,81,29,436,Positive
2025-04-21,Facebook,10631,386,61,66,513,Neutral
2025-04-22,Instagram,14303,251,63,10,324,Positive
2025-04-23,Instagram,13217,141,50,68,259,Negative
2025-04-24,Twitter,19590,425,51,29,505,Neutral
2025-04-25,Facebook,18947,249,30,51,330,Negative
2025-04-26,Twitter,14929,173,99,13,285,Positive
2025-04-27,Instagram,18205,334,29,68,431,Neutral
2025-04-28,Instagram,15068,467,20,27,514,Neutral
2025-04-29,Instagram,10745,196,68,59,323,Positive
2025-04-30,Twitter,13025,200,24,27,251,Positive
2025-05-01,Instagram,15724,449,42,32,523,Positive
2025-05-02,Facebook,16030,361,75,65,501,Negative
2025-05-03,Instagram,16198,168,23,56,247,Positive
2025-05-04,Twitter,12163,207,51,45,303,Negative
2025-05-05,Twitter,15449,151,74,37,262,Positive
2025-05-06,Twitter,16128,404,57,32,493,Negative
2025-05-07,Twitter,10314,496,37,38,571,Positive
2025-05-08,Facebook,18189,483,97,12,592,Negative
2025-05-09,Twitter,11802,250,73,51,374,Neutral
2025-05-10,Instagram,10665,435,77,44,556,Negative
2025-05-11,Twitter,10778,361,68,34,463,Positive
2025-05-12,Facebook,18425,160,47,47,254,Positive
2025-05-13,Instagram,12462,256,63,63,382,Positive
2025-05-14,Facebook,16068,118,27,58,203,Negative
2025-05-15,Facebook,16927,306,24,55,385,Neutral
2025-05-16,Instagram,16526,359,93,29,481,Positive
2025-05-17,Facebook,15719,309,68,47,424,Positive
2025-05-18,Instagram,16448,290,42,54,386,Negative
2025-05-19,Instagram,15168,444,49,28,521,Positive
2025-05-20,Twitter,10009,447,38,17,502,Negative
2025-05-21,Instagram,16451,107,54,50,211,Negative
2025-05-22,Instagram,19566,155,82,47,284,Neutral
2025-05-23,Facebook,15403,478,65,51,594,Neutral
2025-05-24,Facebook,14340,207,23,35,265,Neutral
2025-05-25,Instagram,13770,286,35,40,361,Negative
2025-05-26,Instagram,19348,385,35,10,430,Positive
2025-05-27,Instagram,15312,472,22,16,510,Positive
2025-05-28,Twitter,10943,327,21,29,377,Positive
2025-05-29,Twitter,13751,211,74,11,296,Negative
2025-05-30,Instagram,10077,146,95,26,267,Neutral
2025-05-31,Instagram,11910,251,43,32,326,Positive
2025-06-01,Facebook,14187,433,77,35,545,Neutral
2025-06-02,Instagram,19198,224,78,49,351,Neutral
2025-06-03,Twitter,10270,141,48,25,214,Positive
2025-06-04,Instagram,13409,136,27,39,202,Positive
2025-06-05,Facebook,14324,267,84,45,396,Neutral
2025-06-06,Twitter,18776,265,42,27,334,Positive
2025-06-07,Facebook,14477,393,33,55,481,Positive
2025-06-08,Twitter,11205,167,64,67,298,Neutral
2025-06-09,Twitter,14782,470,84,35,589,Neutral
2025-06-10,Twitter,19572,352,70,46,468,Neutral
2025-06-11,Instagram,11734,230,23,59,312,Positive
2025-06-12,Instagram,19855,209,94,13,316,Positive
2025-06-13,Instagram,10841,353,76,65,494,Neutral
2025-06-14,Twitter,15819,450,88,16,554,Positive
2025-06-15,Instagram,12326,244,52,29,325,Positive
2025-06-16,Twitter,16082,275,88,16,379,Neutral
2025-06-17,Instagram,18138,140,44,37,221,Neutral
2025-06-18,Instagram,16980,369,64,14,447,Neutral
2025-06-19,Twitter,18777,498,87,49,634,Negative
2025-06-20,Instagram,18336,487,95,12,594,Neutral
2025-06-21,Facebook,18190,490,78,52,620,Neutral
2025-06-22,Instagram,14051,163,83,20,266,Positive
2025-06-23,Instagram,10693,105,75,27,207,Negative
2025-06-24,Instagram,16122,225,72,11,308,Positive
2025-06-25,Instagram,14862,184,81,26,291,Negative
2025-06-26,Twitter,10165,332,96,58,486,Positive
2025-06-27,Twitter,10296,287,78,66,431,Negative
2025-06-28,Twitter,13591,326,21,30,377,Neutral
2025-06-29,Instagram,11113,409,57,51,517,Positive
2025-06-30,Facebook,14838,393,34,11,438,Positive
2025-07-01,Twitter,10444,104,47,28,179,Positive
2025-07-02,Instagram,19077,340,85,56,481,Neutral
2025-07-03,Instagram,18888,197,27,51,275,Negative
2025-07-04,Facebook,16452,245,24,55,324,Positive
2025-07-05,Facebook,17891,355,46,25,426,Positive
2025-07-06,Instagram,10345,105,68,64,237,Positive
2025-07-07,Facebook,15574,337,92,13,442,Negative
2025-07-08,Twitter,10142,476,37,17,530,Positive
2025-07-09,Twitter,10623,267,21,56,344,Positive
2025-07-10,Facebook,17019,432,94,35,561,Positive
2025-07-11,Facebook,17445,337,80,22,439,Positive
2025-07-12,Twitter,11632,354,64,15,433,Negative
2025-07-13,Instagram,13089,303,46,35,384,Positive
2025-07-14,Instagram,18053,354,49,62,465,Positive
2025-07-15,Facebook,16198,199,57,43,299,Negative
2025-07-16,Facebook,11013,284,58,18,360,Neutral
2025-07-17,Instagram,13022,286,52,22,360,Neutral
2025-07-18,Facebook,10505,247,67,26,340,Neutral
2025-07-19,Instagram,19780,411,38,14,463,Neutral
2025-07-20,Twitter,18197,161,77,10,248,Positive
2025-07-21,Twitter,14994,276,87,40,403,Positive
2025-07-22,Facebook,16341,369,76,26,471,Negative
2025-07-23,Twitter,12138,287,99,26,412,Negative
2025-07-24,Twitter,14050,363,89,24,476,Positive
2025-07-25,Instagram,17118,231,50,57,338,Positive
2025-07-26,Twitter,14987,102,46,51,199,Neutral
2025-07-27,Instagram,13452,130,55,18,203,Positive
2025-07-28,Instagram,11486,460,58,43,561,Neutral
2025-07-29,Facebook,12752,426,49,56,531,Negative
2025-07-30,Instagram,17866,324,47,35,406,Negative
2025-07-31,Facebook,10281,413,90,61,564,Positive
2025-08-01,Twitter,17623,410,97,53,560,Negative
2025-08-02,Instagram,15708,460,27,47,534,Negative
2025-08-03,Instagram,15924,390,53,61,504,Positive
2025-08-04,Twitter,18700,433,44,68,545,Negative
2025-08-05,Instagram,16290,284,99,66,449,Neutral
2025-08-06,Facebook,19166,338,94,40,472,Neutral
2025-08-07,Facebook,15290,253,50,20,323,Positive
2025-08-08,Facebook,14325,189,96,67,352,Negative
2025-08-09,Facebook,15275,466,89,53,608,Negative
2025-08-10,Facebook,19053,202,39,20,261,Negative
2025-08-11,Facebook,15997,206,92,10,308,Neutral
2025-08-12,Instagram,12837,387,85,38,510,Neutral
2025-08-13,Facebook,16892,301,31,68,400,Positive
2025-08-14,Facebook,13731,113,89,64,266,Positive
2025-08-15,Facebook,14916,420,96,12,528,Negative
2025-08-16,Twitter,15522,106,21,21,148,Positive
2025-08-17,Instagram,11843,477,82,20,579,Positive
2025-08-18,Instagram,16044,342,67,65,474,Negative
2025-08-19,Instagram,19827,366,56,19,441,Neutral
2025-08-20,Twitter,10114,129,50,62,241,Positive
2025-08-21,Twitter,16318,293,75,36,404,Negative
2025-08-22,Instagram,19121,356,94,53,503,Negative
2025-08-23,Instagram,13027,409,42,60,511,Negative
2025-08-24,Facebook,18407,394,36,34,464,Positive
2025-08-25,Twitter,15382,143,38,59,240,Negative
2025-08-26,Instagram,15915,180,58,64,302,Neutral
2025-08-27,Twitter,10382,235,70,65,370,Positive
2025-08-28,Facebook,19539,165,75,13,253,Neutral
2025-08-29,Twitter,19691,359,97,47,503,Neutral
2025-08-30,Twitter,16250,158,73,42,273,Negative
2025-08-31,Instagram,12700,185,65,42,292,Negative
2025-09-01,Instagram,19298,347,23,60,430,Neutral
2025-09-02,Instagram,18127,308,49,64,421,Positive
2025-09-03,Instagram,13692,234,94,35,363,Negative
2025-09-04,Twitter,13573,126,57,34,217,Positive
2025-09-05,Instagram,11448,232,54,21,307,Negative
2025-09-06,Instagram,19901,130,96,16,242,Positive
2025-09-07,Instagram,12350,106,25,29,160,Neutral
2025-09-08,Twitter,10571,290,56,41,387,Negative
2025-09-09,Instagram,11964,236,97,11,344,Negative
2025-09-10,Instagram,18722,390,41,23,454,Positive
2025-09-11,Twitter,10985,175,71,23,269,Neutral
2025-09-12,Facebook,17924,489,41,42,572,Positive
2025-09-13,Twitter,19972,419,63,55,537,Neutral
2025-09-14,Facebook,18670,483,56,61,600,Positive
2025-09-15,Instagram,18298,132,50,10,192,Neutral
2025-09-16,Twitter,13601,294,47,52,393,Positive
2025-09-17,Facebook,17297,217,73,13,303,Neutral
2025-09-18,Facebook,18342,265,21,12,298,Positive
2025-09-19,Facebook,13702,245,34,29,308,Positive
2025-09-20,Facebook,12380,497,83,30,610,Negative
2025-09-21,Facebook,14240,232,78,65,375,Positive
2025-09-22,Instagram,11820,295,79,38,412,Positive
2025-09-23,Instagram,18206,453,31,19,503,Negative
2025-09-24,Facebook,17186,361,74,62,497,Negative
2025-09-25,Twitter,13580,450,88,15,553,Neutral
2025-09-26,Facebook,10280,377,76,52,505,Negative
2025-09-27,Instagram,19525,422,72,23,517,Negative
2025-09-28,Twitter,11422,232,73,11,316,Neutral
2025-09-29,Instagram,19535,373,31,32,436,Negative
2025-09-30,Twitter,14463,474,44,52,570,Negative
2025-10-01,Instagram,14328,379,47,68,494,Negative
2025-10-02,Facebook,18226,413,90,62,565,Negative
2025-10-03,Twitter,13032,170,43,61,274,Neutral
2025-10-04,Twitter,10304,407,80,12,499,Negative
2025-10-05,Instagram,17871,397,60,53,510,Positive
2025-10-06,Instagram,13616,260,50,27,337,Neutral
2025-10-07,Facebook,11830,399,81,45,525,Negative
2025-10-08,Instagram,10417,129,50,17,196,Positive
2025-10-09,Twitter,10383,476,71,46,593,Neutral
2025-10-10,Twitter,13825,481,88,50,619,Neutral
2025-10-11,Twitter,12312,422,81,32,535,Neutral
2025-10-12,Facebook,17814,157,82,26,265,Positive
2025-10-13,Facebook,10802,432,94,42,568,Neutral
2025-10-14,Twitter,18364,221,40,68,329,Negative
2025-10-15,Facebook,15707,452,94,23,569,Positive
2025-10-16,Twitter,11159,137,81,28,246,Neutral
2025-10-17,Twitter,15522,234,38,39,311,Negative
2025-10-18,Twitter,13464,223,65,25,313,Negative
2025-10-19,Twitter,17355,279,90,47,416,Neutral
2025-10-20,Instagram,18029,215,50,54,319,Neutral
2025-10-21,Instagram,10324,338,82,65,485,Neutral
2025-10-22,Instagram,13327,420,64,65,549,Negative
2025-10-23,Twitter,19744,245,23,38,306,Positive
2025-10-24,Instagram,17466,222,87,39,348,Positive
2025-10-25,Facebook,10287,255,92,68,415,Neutral
2025-10-26,Twitter,18116,222,72,60,354,Negative
2025-10-27,Facebook,11097,191,96,55,342,Neutral
2025-10-28,Twitter,10615,118,43,47,208,Negative
2025-10-29,Facebook,19676,173,29,47,249,Positive
2025-10-30,Facebook,16067,410,53,39,502,Positive
2025-10-31,Twitter,13301,231,90,38,359,Negative
2025-11-01,Instagram,15724,302,42,15,359,Positive
2025-11-02,Facebook,15623,332,87,48,467,Neutral
2025-11-03,Facebook,10412,178,31,50,259,Positive
2025-11-04,Twitter,10722,168,74,41,283,Positive
2025-11-05,Facebook,18152,163,32,10,205,Neutral
2025-11-06,Instagram,11083,422,55,34,511,Positive
2025-11-07,Instagram,10990,274,40,44,358,Positive
2025-11-08,Twitter,13887,422,98,52,572,Positive
2025-11-09,Twitter,18930,193,90,10,293,Negative
2025-11-10,Twitter,15524,255,96,33,384,Positive
2025-11-11,Twitter,14728,293,38,20,351,Neutral
2025-11-12,Instagram,14478,180,91,49,320,Positive
2025-11-13,Facebook,13652,439,59,14,512,Positive
2025-11-14,Twitter,13275,105,61,40,206,Neutral
2025-11-15,Instagram,12315,235,98,67,400,Negative
2025-11-16,Instagram,17195,444,26,19,489,Positive
2025-11-17,Instagram,11192,380,36,44,460,Neutral
2025-11-18,Twitter,13100,294,77,40,411,Negative
2025-11-19,Facebook,10538,257,75,42,374,Neutral
2025-11-20,Instagram,19505,371,56,24,451,Neutral
2025-11-21,Facebook,10155,251,71,56,378,Negative
2025-11-22,Twitter,17983,365,96,46,507,Positive
2025-11-23,Twitter,16808,233,96,62,391,Positive
2025-11-24,Facebook,13688,117,74,31,222,Neutral
2025-11-25,Instagram,12229,262,56,43,361,Positive
2025-11-26,Instagram,11163,334,51,52,437,Negative
2025-11-27,Facebook,18951,375,83,30,488,Neutral
2025-11-28,Twitter,14462,446,43,58,547,Negative
2025-11-29,Instagram,17169,237,54,13,304,Negative
2025-11-30,Facebook,10350,110,89,11,210,Positive
2025-12-01,Instagram,14354,328,73,43,444,Positive
2025-12-02,Instagram,11145,493,86,24,603,Neutral
2025-12-03,Instagram,18826,480,45,11,536,Neutral
2025-12-04,Instagram,17683,114,89,34,237,Negative
2025-12-05,Twitter,13806,359,79,22,460,Neutral
2025-12-06,Instagram,12498,383,28,13,424,Positive
2025-12-07,Facebook,11455,226,82,35,343,Neutral
2025-12-08,Twitter,19159,171,32,36,239,Neutral
2025-12-09,Instagram,12619,284,56,38,378,Positive
2025-12-10,Instagram,13577,110,21,48,179,Positive
2025-12-11,Twitter,14854,365,23,46,434,Negative
2025-12-12,Instagram,16321,181,26,15,222,Negative
2025-12-13,Instagram,11086,405,59,34,498,Neutral
2025-12-14,Facebook,15498,370,78,13,461,Positive
2025-12-15,Twitter,14358,364,23,55,442,Negative
2025-12-16,Instagram,18839,178,41,67,286,Positive
2025-12-17,Facebook,12735,282,41,39,362,Negative
2025-12-18,Facebook,10328,364,53,61,478,Positive
2025-12-19,Instagram,17599,482,76,69,627,Positive
2025-12-20,Twitter,11266,470,56,28,554,Neutral
2025-12-21,Instagram,11084,284,50,37,371,Neutral
2025-12-22,Instagram,19353,421,56,26,503,Positive
2025-12-23,Twitter,18350,158,25,46,229,Neutral
2025-12-24,Facebook,17080,163,77,15,255,Neutral
2025-12-25,Instagram,11060,266,81,35,382,Negative
2025-12-26,Twitter,18805,157,79,35,271,Neutral
2025-12-27,Instagram,17782,457,56,22,535,Negative
2025-12-28,Instagram,18234,379,37,35,451,Negative
2025-12-29,Twitter,10630,210,33,58,301,Positive
2025-12-30,Twitter,11759,191,69,48,308,Negative
2025-12-31,Instagram,12664,266,88,16,370,Positive
2026-01-01,Twitter,12877,492,74,32,598,Negative
2026-01-02,Twitter,19064,402,21,19,442,Neutral
2026-01-03,Instagram,10446,201,52,42,295,Negative
2026-01-04,Instagram,10735,154,32,29,215,Negative
2026-01-05,Instagram,12012,237,64,24,325,Negative
2026-01-06,Twitter,15286,212,86,26,324,Negative
2026-01-07,Facebook,17824,290,37,50,377,Negative
2026-01-08,Instagram,10123,317,65,53,435,Negative
2026-01-09,Twitter,15436,459,66,47,572,Positive
2026-01-10,Facebook,12289,148,23,65,236,Negative
2026-01-11,Instagram,18200,192,26,59,277,Positive
2026-01-12,Facebook,17803,351,56,41,448,Neutral
2026-01-13,Instagram,19963,376,25,19,420,Negative
2026-01-14,Facebook,11369,458,65,16,539,Neutral
2026-01-15,Facebook,11839,296,62,14,372,Neutral
2026-01-16,Instagram,14040,274,58,52,384,Negative
2026-01-17,Facebook,12747,207,76,12,295,Neutral
2026-01-18,Instagram,11721,113,30,18,161,Positive
2026-01-19,Instagram,17816,189,61,11,261,Positive
2026-01-20,Facebook,16940,429,55,45,529,Neutral
2026-01-21,Twitter,19003,131,22,39,192,Neutral
2026-01-22,Facebook,15568,404,68,69,541,Positive
2026-01-23,Twitter,16345,421,76,55,552,Positive
2026-01-24,Facebook,17122,423,31,10,464,Positive
2026-01-25,Twitter,10631,433,30,14,477,Positive
2026-01-26,Twitter,17382,379,79,58,516,Positive
2026-01-27,Twitter,16141,458,39,39,536,Neutral
2026-01-28,Twitter,19026,106,84,43,233,Positive
2026-01-29,Twitter,10591,301,37,18,356,Negative
2026-01-30,Facebook,15835,301,93,35,429,Neutral
2026-01-31,Facebook,10843,434,90,16,540,Positive
2026-02-01,Instagram,17737,412,59,22,493,Positive
2026-02-02,Instagram,13911,410,59,49,518,Neutral
2026-02-03,Facebook,11391,489,61,40,590,Negative
2026-02-04,Facebook,11183,284,28,45,357,Negative
2026-02-05,Facebook,11662,164,77,26,267,Negative
2026-02-06,Twitter,11814,297,65,54,416,Positive
2026-02-07,Facebook,17285,256,73,54,383,Positive
2026-02-08,Facebook,12915,380,70,16,466,Positive
2026-02-09,Facebook,17926,259,82,10,351,Positive
2026-02-10,Facebook,15003,323,98,13,434,Positive
2026-02-11,Facebook,17797,345,45,37,427,Negative
2026-02-12,Twitter,18617,148,52,49,249,Neutral
2026-02-13,Facebook,10486,109,52,59,220,Neutral
2026-02-14,Twitter,14089,271,80,49,400,Neutral
2026-02-15,Instagram,13425,129,53,11,193,Positive
2026-02-16,Instagram,12981,386,47,68,501,Positive
2026-02-17,Facebook,16674,458,93,34,585,Neutral
2026-02-18,Facebook,14088,227,47,54,328,Positive
2026-02-19,Twitter,17400,458,46,15,519,Positive
2026-02-20,Instagram,18042,117,37,59,213,Neutral
2026-02-21,Instagram,10886,387,42,39,468,Positive
2026-02-22,Facebook,13451,345,35,26,406,Neutral
2026-02-23,Twitter,18835,118,57,66,241,Neutral
2026-02-24,Twitter,11590,130,85,11,226,Negative
2026-02-25,Facebook,10808,384,30,14,428,Neutral
2026-02-26,Instagram,18635,390,40,62,492,Negative
2026-02-27,Instagram,11776,403,32,18,453,Neutral
2026-02-28,Instagram,10315,176,44,38,258,Negative
2026-03-01,Twitter,14211,249,73,36,358,Positive
2026-03-02,Twitter,15358,447,20,57,524,Neutral
2026-03-03,Facebook,16163,350,50,23,423,Neutral
2026-03-04,Facebook,11693,395,85,47,527,Positive
2026-03-05,Facebook,17661,133,42,42,217,Positive
2026-03-06,Twitter,11632,303,44,37,384,Positive
2026-03-07,Facebook,11803,193,73,15,281,Negative
2026-03-08,Facebook,15179,219,44,27,290,Negative
2026-03-09,Twitter,15351,256,65,27,348,Positive
2026-03-10,Facebook,16952,320,40,14,374,Positive
2026-03-11,Facebook,14626,268,21,47,336,Positive
2026-03-12,Facebook,19767,377,21,26,424,Positive
2026-03-13,Twitter,16476,443,22,33,498,Negative
2026-03-14,Twitter,11128,104,58,16,178,Negative
2026-03-15,Twitter,11974,339,54,28,421,Negative
2026-03-16,Facebook,16001,296,46,14,356,Neutral
2026-03-17,Twitter,14571,145,73,20,238,Positive
2026-03-18,Twitter,17480,344,83,52,479,Negative
2026-03-19,Twitter,16987,296,94,18,408,Neutral
2026-03-20,Facebook,13976,207,67,20,294,Neutral
2026-03-21,Twitter,15167,149,66,49,264,Negative
2026-03-22,Instagram,16048,387,77,24,488,Neutral
2026-03-23,Twitter,13808,493,77,15,585,Neutral
2026-03-24,Instagram,10976,225,39,35,299,Positive
2026-03-25,Facebook,13233,262,30,48,340,Neutral
2026-03-26,Twitter,16384,372,89,29,490,Negative
2026-03-27,Instagram,12380,293,25,16,334,Positive
2026-03-28,Instagram,11108,431,52,23,506,Negative
2026-03-29,Facebook,10854,440,48,51,539,Negative
2026-03-30,Facebook,16934,310,74,46,430,Negative
2026-03-31,Instagram,19229,430,53,50,533,Negative
2026-04-01,Facebook,15476,357,55,53,465,Positive
2026-04-02,Twitter,17308,378,75,24,477,Neutral
2026-04-03,Instagram,16976,244,89,41,374,Negative
2026-04-04,Facebook,17206,449,86,12,547,Negative
2026-04-05,Facebook,19083,222,22,67,311,Neutral
2026-04-06,Twitter,10760,458,95,47,600,Negative
2026-04-07,Facebook,13384,464,28,53,545,Positive
2026-04-08,Instagram,11521,392,25,36,453,Positive
2026-04-09,Facebook,19123,376,90,57,523,Positive
2026-04-10,Instagram,11482,299,27,45,371,Positive
2026-04-11,Instagram,11966,270,22,49,341,Positive
2026-04-12,Instagram,19350,436,35,52,523,Positive
2026-04-13,Instagram,15780,145,70,47,262,Positive
2026-04-14,Twitter,14920,326,87,42,455,Negative
2026-04-15,Twitter,12224,355,89,30,474,Negative
2026-04-16,Twitter,18105,125,88,16,229,Positive
2026-04-17,Instagram,16030,339,71,22,432,Neutral
2026-04-18,Instagram,12960,322,81,60,463,Negative
2026-04-19,Instagram,16011,179,49,67,295,Negative
2026-04-20,Instagram,11798,344,46,67,457,Negative
2026-04-21,Twitter,11194,429,93,22,544,Negative
2026-04-22,Facebook,12940,341,22,58,421,Positive
2026-04-23,Facebook,14128,432,87,23,542,Neutral
2026-04-24,Instagram,13010,374,33,47,454,Positive
2026-04-25,Twitter,13979,498,87,52,637,Positive
2026-04-26,Instagram,10961,428,98,60,586,Positive
2026-04-27,Facebook,10996,202,86,64,352,Negative
2026-04-28,Instagram,19990,195,43,24,262,Neutral
2026-04-29,Instagram,13516,161,46,27,234,Negative
2026-04-30,Twitter,10600,173,74,25,272,Negative
2026-05-01,Instagram,12239,412,76,62,550,Neutral
2026-05-02,Twitter,17877,302,97,57,456,Positive
2026-05-03,Facebook,17167,149,72,16,237,Negative
2026-05-04,Facebook,17131,114,81,58,253,Positive
2026-05-05,Twitter,11518,303,38,64,405,Positive
2026-05-06,Twitter,17974,397,97,60,554,Negative
2026-05-07,Twitter,15571,201,75,38,314,Negative
2026-05-08,Twitter,19135,405,64,53,522,Negative
2026-05-09,Instagram,14586,494,64,32,590,Neutral
2026-05-10,Instagram,19339,113,44,44,201,Neutral
2026-05-11,Instagram,10634,264,68,25,357,Negative
2026-05-12,Instagram,10098,432,83,35,550,Neutral
2026-05-13,Twitter,12580,175,68,68,311,Negative
2026-05-14,Facebook,15324,422,77,69,568,Neutral
2026-05-15,Twitter,17842,302,42,40,384,Negative
2026-05-16,Facebook,17811,460,85,61,606,Negative
2026-05-17,Twitter,19915,399,72,38,509,Negative
2026-05-18,Instagram,12594,117,79,32,228,Neutral
2026-05-19,Facebook,11975,160,96,62,318,Positive
2026-05-20,Twitter,14986,206,93,48,347,Positive
2026-05-21,Instagram,19666,148,44,50,242,Neutral
2026-05-22,Twitter,14047,362,75,43,480,Neutral
2026-05-23,Twitter,10084,197,47,55,299,Negative
2026-05-24,Instagram,15257,104,61,27,192,Neutral
2026-05-25,Instagram,10116,188,33,26,247,Neutral
2026-05-26,Instagram,18723,456,48,53,557,Neutral
2026-05-27,Twitter,19220,121,82,41,244,Negative
2026-05-28,Twitter,13882,316,74,23,413,Negative
2026-05-29,Facebook,14169,214,47,52,313,Positive
2026-05-30,Instagram,13770,253,47,36,336,Positive
2026-05-31,Instagram,18250,344,55,62,461,Positive
2026-06-01,Instagram,13048,230,97,67,394,Neutral
2026-06-02,Facebook,17752,135,55,69,259,Positive
2026-06-03,Instagram,11378,266,93,24,383,Positive
2026-06-04,Twitter,14078,211,53,14,278,Neutral
2026-06-05,Twitter,11945,438,45,19,502,Positive
2026-06-06,Facebook,15003,295,64,31,390,Positive
2026-06-07,Facebook,16029,345,81,22,448,Positive
2026-06-08,Twitter,13253,277,38,35,350,Negative
2026-06-09,Facebook,11206,424,51,28,503,Positive
2026-06-10,Instagram,17631,144,22,54,220,Negative
2026-06-11,Twitter,13649,136,62,52,250,Positive
2026-06-12,Instagram,18394,305,71,37,413,Negative
2026-06-13,Twitter,13112,100,78,65,243,Negative
2026-06-14,Twitter,15854,239,52,59,350,Negative
2026-06-15,Instagram,10544,167,28,25,220,Negative
2026-06-16,Twitter,12881,417,83,47,547,Neutral
2026-06-17,Twitter,16612,273,40,25,338,Neutral
2026-06-18,Facebook,13813,405,42,64,511,Negative
2026-06-19,Facebook,15686,387,63,15,465,Neutral
2026-06-20,Instagram,13685,280,65,60,405,Neutral
2026-06-21,Facebook,15584,498,63,65,626,Negative
2026-06-22,Facebook,11085,201,46,47,294,Neutral
2026-06-23,Twitter,14502,171,47,66,284,Neutral
2026-06-24,Facebook,14120,288,62,69,419,Positive
2026-06-25,Twitter,19823,371,51,61,483,Neutral
2026-06-26,Facebook,16822,282,63,32,377,Neutral
2026-06-27,Facebook,10866,197,49,61,307,Negative
2026-06-28,Facebook,18485,463,35,59,557,Negative
2026-06-29,Instagram,12725,495,58,43,596,Positive
2026-06-30,Twitter,15858,127,65,58,250,Neutral
2026-07-01,Twitter,14587,483,63,64,610,Negative
2026-07-02,Twitter,14261,429,59,68,556,Neutral
2026-07-03,Facebook,18068,242,24,34,300,Negative
2026-07-04,Instagram,12584,285,38,14,337,Negative
2026-07-05,Twitter,14801,390,33,52,475,Negative
2026-07-06,Instagram,13367,421,58,53,532,Negative
2026-07-07,Instagram,15874,142,99,27,268,Negative
2026-07-08,Twitter,10758,229,76,36,341,Positive
2026-07-09,Twitter,10074,322,40,26,388,Negative
2026-07-10,Twitter,19050,214,25,41,280,Negative
2026-07-11,Instagram,10323,242,21,25,288,Negative
2026-07-12,Facebook,13447,387,75,26,488,Negative
2026-07-13,Instagram,18202,187,37,27,251,Negative
2026-07-14,Facebook,13028,100,27,27,154,Negative
2026-07-15,Instagram,11228,413,84,16,513,Neutral
2026-07-16,Facebook,19782,148,70,23,241,Negative
2026-07-17,Facebook,12290,299,79,40,418,Neutral
2026-07-18,Facebook,16797,373,80,44,497,Negative
2026-07-19,Twitter,11884,466,46,31,543,Negative
2026-07-20,Instagram,14173,393,30,69,492,Negative
2026-07-21,Facebook,12809,103,61,20,184,Negative
2026-07-22,Twitter,11327,144,98,69,311,Neutral
2026-07-23,Twitter,15902,137,60,12,209,Positive
2026-07-24,Twitter,18844,320,75,46,441,Neutral
2026-07-25,Instagram,14954,463,26,41,530,Negative
2026-07-26,Twitter,15687,371,66,50,487,Positive
2026-07-27,Twitter,10971,115,76,12,203,Positive
2026-07-28,Facebook,18395,321,27,27,375,Negative
2026-07-29,Instagram,17083,354,91,12,457,Negative
2026-07-30,Twitter,10665,116,68,20,204,Positive
2026-07-31,Facebook,17894,109,99,56,264,Neutral
2026-08-01,Twitter,13500,378,51,53,482,Neutral
2026-08-02,Instagram,13444,234,75,68,377,Negative
2026-08-03,Facebook,14443,484,86,38,608,Negative
2026-08-04,Twitter,11577,102,50,18,170,Negative
2026-08-05,Instagram,17465,477,82,33,592,Negative
2026-08-06,Instagram,19848,414,56,45,515,Positive
2026-08-07,Facebook,14655,366,98,17,481,Positive
2026-08-08,Facebook,12958,135,93,40,268,Positive
2026-08-09,Facebook,18118,171,86,10,267,Positive
2026-08-10,Twitter,11437,326,40,23,389,Negative
2026-08-11,Twitter,16998,120,21,66,207,Neutral
2026-08-12,Twitter,12842,444,95,62,601,Neutral
2026-08-13,Facebook,17621,116,53,21,190,Negative
2026-08-14,Facebook,13469,206,61,33,300,Neutral
2026-08-15,Facebook,16505,441,73,42,556,Positive
2026-08-16,Twitter,13444,117,40,43,200,Positive
2026-08-17,Instagram,11999,333,70,64,467,Positive
2026-08-18,Twitter,12737,108,56,17,181,Negative
2026-08-19,Instagram,14927,393,53,12,458,Neutral
2026-08-20,Instagram,19989,288,97,20,405,Positive
2026-08-21,Facebook,10343,368,33,53,454,Negative
2026-08-22,Facebook,13160,410,31,47,488,Negative
2026-08-23,Instagram,10228,137,83,69,289,Negative
2026-08-24,Facebook,15264,487,35,30,552,Positive
2026-08-25,Twitter,12418,379,88,68,535,Negative
2026-08-26,Facebook,18573,360,32,34,426,Neutral
2026-08-27,Facebook,12422,215,95,42,352,Negative
2026-08-28,Facebook,14952,285,86,19,390,Neutral
2026-08-29,Twitter,12548,284,29,50,363,Positive
2026-08-30,Twitter,13954,420,59,43,522,Neutral
2026-08-31,Instagram,18890,387,39,15,441,Positive
2026-09-01,Instagram,18597,274,58,47,379,Negative
2026-09-02,Instagram,14499,324,77,68,469,Neutral
2026-09-03,Twitter,18575,488,77,15,580,Negative
2026-09-04,Twitter,18003,360,76,68,504,Neutral
2026-09-05,Twitter,19705,339,26,42,407,Neutral
2026-09-06,Facebook,14705,316,34,50,400,Negative
2026-09-07,Instagram,18857,456,70,42,568,Negative
2026-09-08,Instagram,13836,487,50,33,570,Positive
2026-09-09,Facebook,15174,369,81,33,483,Positive
2026-09-10,Instagram,11372,158,20,47,225,Neutral
2026-09-11,Facebook,14279,459,91,22,572,Neutral
2026-09-12,Facebook,18499,442,51,43,536,Neutral
2026-09-13,Twitter,13160,123,28,30,181,Neutral
2026-09-14,Facebook,16503,318,26,14,358,Positive
2026-09-15,Instagram,18311,478,70,15,563,Negative
2026-09-16,Twitter,15615,247,21,28,296,Positive
2026-09-17,Instagram,19030,494,27,22,543,Neutral
2026-09-18,Twitter,13943,167,99,27,293,Positive
2026-09-19,Facebook,16909,153,63,15,231,Negative
2026-09-20,Facebook,14175,482,56,67,605,Neutral
2026-09-21,Twitter,11614,366,51,66,483,Neutral
2026-09-22,Twitter,12151,343,34,22,399,Neutral
2026-09-23,Facebook,10023,395,61,29,485,Neutral
2026-09-24,Facebook,10298,297,90,46,433,Neutral
2026-09-25,Twitter,13369,164,66,68,298,Neutral
2026-09-26,Instagram,15133,490,26,16,532,Positive
